Date,susceptible,exposed,infectious,recovered,dead,immune,num infections today,num hospitalisations today,hospital bed occupancy,num hospitalisations today (data),cum num hospitalisations today,cum num infections today
3/2/2020,3311,439,473,480,0,0,94,1,12,0,1,94
3/3/2020,3211,431,496,564,1,0,100,3,14,0,4,194
3/4/2020,3083,436,554,629,1,0,128,4,18,0,8,322
3/5/2020,2987,426,585,704,1,0,96,2,20,0,10,418
3/6/2020,2866,439,596,800,2,0,121,2,21,0,12,539
3/7/2020,2743,461,607,889,3,0,123,4,24,0,16,662
3/8/2020,2639,451,621,989,3,0,104,7,30,0,23,766
3/9/2020,2547,434,617,1102,3,0,92,2,30,0,25,858
3/10/2020,2463,394,655,1188,3,0,84,8,38,0,33,942
3/11/2020,2385,383,645,1286,4,0,78,5,41,0,38,1020
3/12/2020,2307,351,649,1390,6,0,79,4,41,0,42,1099
3/13/2020,2266,303,620,1507,7,0,42,7,47,0,49,1141
3/14/2020,2215,258,609,1614,7,0,51,6,51,0,55,1192
3/15/2020,2173,222,578,1722,8,0,42,8,57,0,63,1234
3/16/2020,2133,202,522,1837,9,0,40,5,60,0,68,1274
3/17/2020,2116,169,486,1921,11,0,17,6,62,0,74,1291
3/18/2020,2098,142,463,1989,11,0,18,7,66,0,81,1309
3/19/2020,2083,106,427,2075,12,0,15,10,75,0,91,1324
3/20/2020,2067,87,390,2147,12,0,16,3,75,0,94,1340
3/21/2020,2061,63,349,2218,12,0,6,4,74,0,98,1346
3/22/2020,2055,49,289,2296,14,0,6,9,78,0,107,1352
3/23/2020,2048,40,260,2337,18,0,7,7,78,0,114,1359
3/24/2020,2042,34,221,2387,19,0,6,7,78,0,121,1365
3/25/2020,2042,21,187,2431,22,0,0,3,74,0,124,1365
3/26/2020,2040,13,172,2454,24,0,2,4,73,0,128,1367
3/27/2020,2038,6,150,2483,26,0,2,3,63,0,131,1369
3/28/2020,2036,7,122,2507,31,0,2,4,60,0,135,1371
3/29/2020,2036,4,106,2524,33,0,0,5,57,0,140,1371
3/30/2020,2035,3,92,2540,33,0,1,0,54,0,140,1372
3/31/2020,2035,2,77,2556,33,0,0,1,50,0,141,1372
4/1/2020,2034,3,64,2569,33,0,1,2,46,0,143,1373
4/2/2020,2034,2,55,2576,36,0,0,2,43,0,145,1373
4/3/2020,2034,2,47,2584,36,0,0,0,38,0,145,1373
4/4/2020,2034,2,36,2592,39,0,0,0,31,0,145,1373
4/5/2020,2034,2,30,2598,39,0,0,0,26,0,145,1373
4/6/2020,2034,1,26,2601,41,0,0,1,22,0,146,1373
4/7/2020,2034,1,20,2606,42,0,0,0,18,0,146,1373
4/8/2020,2034,0,18,2609,42,0,0,0,16,0,146,1373
4/9/2020,2034,0,12,2613,44,0,0,0,12,0,146,1373
4/10/2020,2034,0,8,2616,45,0,0,0,8,0,146,1373
4/11/2020,2034,0,6,2618,45,0,0,0,6,0,146,1373
4/12/2020,2034,0,6,2618,45,0,0,0,6,0,146,1373
4/13/2020,2034,0,5,2619,45,0,0,0,5,0,146,1373
4/14/2020,2034,0,5,2619,45,0,0,0,5,0,146,1373
4/15/2020,2034,0,5,2619,45,0,0,0,5,0,146,1373
4/16/2020,2034,0,4,2620,45,0,0,0,4,0,146,1373
4/17/2020,2034,0,2,2621,46,0,0,0,2,0,146,1373
4/18/2020,2034,0,2,2621,46,0,0,0,2,0,146,1373
4/19/2020,2034,0,2,2621,46,0,0,0,2,0,146,1373
4/20/2020,2034,0,1,2622,46,0,0,0,1,0,146,1373
4/21/2020,2034,0,1,2622,46,0,0,0,1,0,146,1373
4/22/2020,2034,0,1,2622,46,0,0,0,1,0,146,1373
4/23/2020,2034,0,0,2622,47,0,0,0,0,0,146,1373
4/24/2020,2034,0,0,2622,47,0,0,0,0,0,146,1373
4/25/2020,2034,0,0,2622,47,0,0,0,0,0,146,1373
4/26/2020,2034,0,0,2622,47,0,0,0,0,0,146,1373
4/27/2020,2034,0,0,2622,47,0,0,0,0,0,146,1373
4/28/2020,2034,0,0,2622,47,0,0,0,0,0,146,1373
4/29/2020,2034,0,0,2622,47,0,0,0,0,0,146,1373
4/30/2020,2034,0,0,2622,47,0,0,0,0,0,146,1373
5/1/2020,2034,0,0,2622,47,0,0,0,0,0,146,1373
5/2/2020,2034,0,0,2622,47,0,0,0,0,0,146,1373
5/3/2020,2034,0,0,2622,47,0,0,0,0,0,146,1373
5/4/2020,2034,0,0,2622,47,0,0,0,0,0,146,1373
5/5/2020,2034,0,0,2622,47,0,0,0,0,0,146,1373
5/6/2020,2034,0,0,2622,47,0,0,0,0,0,146,1373
5/7/2020,2034,0,0,2622,47,0,0,0,0,0,146,1373
5/8/2020,2034,0,0,2622,47,0,0,0,0,0,146,1373
5/9/2020,2034,0,0,2622,47,0,0,0,0,0,146,1373
5/10/2020,2034,0,0,2622,47,0,0,0,0,0,146,1373
5/11/2020,2034,0,0,2622,47,0,0,0,0,0,146,1373
5/12/2020,2034,0,0,2622,47,0,0,0,0,0,146,1373
5/13/2020,2034,0,0,2622,47,0,0,0,0,0,146,1373
5/14/2020,2034,0,0,2622,47,0,0,0,0,0,146,1373
5/15/2020,2034,0,0,2622,47,0,0,0,0,0,146,1373
5/16/2020,2034,0,0,2622,47,0,0,0,0,0,146,1373
5/17/2020,2034,0,0,2622,47,0,0,0,0,0,146,1373
5/18/2020,2034,0,0,2622,47,0,0,0,0,0,146,1373
5/19/2020,2034,0,0,2622,47,0,0,0,0,0,146,1373
5/20/2020,2034,0,0,2622,47,0,0,0,0,0,146,1373
5/21/2020,2034,0,0,2622,47,0,0,0,0,0,146,1373
5/22/2020,2034,0,0,2622,47,0,0,0,0,0,146,1373
5/23/2020,2034,0,0,2622,47,0,0,0,0,0,146,1373
5/24/2020,2034,0,0,2622,47,0,0,0,0,0,146,1373
5/25/2020,2034,0,0,2622,47,0,0,0,0,0,146,1373
5/26/2020,2034,0,0,2622,47,0,0,0,0,0,146,1373
5/27/2020,2034,0,0,2622,47,0,0,0,0,0,146,1373
5/28/2020,2034,0,0,2622,47,0,0,0,0,0,146,1373
5/29/2020,2034,0,0,2622,47,0,0,0,0,0,146,1373
5/30/2020,2034,0,0,2622,47,0,0,0,0,0,146,1373
5/31/2020,2034,0,0,2622,47,0,0,0,0,0,146,1373
6/1/2020,2034,0,0,2622,47,0,0,0,0,0,146,1373
6/2/2020,2034,0,0,2622,47,0,0,0,0,0,146,1373
6/3/2020,2034,0,0,2622,47,0,0,0,0,0,146,1373
6/4/2020,2034,0,0,2622,47,0,0,0,0,0,146,1373
6/5/2020,2034,0,0,2622,47,0,0,0,0,0,146,1373
6/6/2020,2034,0,0,2622,47,0,0,0,0,0,146,1373
6/7/2020,2034,0,0,2622,47,0,0,0,0,0,146,1373
6/8/2020,2034,0,0,2622,47,0,0,0,0,0,146,1373
6/9/2020,2034,0,0,2622,47,0,0,0,0,0,146,1373
6/10/2020,2034,0,0,2622,47,0,0,0,0,0,146,1373
6/11/2020,2034,0,0,2622,47,0,0,0,0,0,146,1373
6/12/2020,2034,0,0,2622,47,0,0,0,0,0,146,1373
6/13/2020,2034,0,0,2622,47,0,0,0,0,0,146,1373
6/14/2020,2034,0,0,2622,47,0,0,0,0,0,146,1373
6/15/2020,2034,0,0,2622,47,0,0,0,0,0,146,1373
6/16/2020,2034,0,0,2622,47,0,0,0,0,0,146,1373
6/17/2020,2034,0,0,2622,47,0,0,0,0,0,146,1373
6/18/2020,2034,0,0,2622,47,0,0,0,0,0,146,1373
6/19/2020,2034,0,0,2622,47,0,0,0,0,0,146,1373
6/20/2020,2035,0,0,2621,47,0,0,0,0,0,146,1373
6/21/2020,2036,0,0,2620,47,0,0,0,0,0,146,1373
6/22/2020,2036,0,0,2620,47,0,0,0,0,0,146,1373
6/23/2020,2036,0,0,2620,47,0,0,0,0,0,146,1373
6/24/2020,2036,0,0,2620,47,0,0,0,0,0,146,1373
6/25/2020,2036,0,0,2620,47,0,0,0,0,0,146,1373
6/26/2020,2038,0,0,2618,47,0,0,0,0,0,146,1373
6/27/2020,2038,0,0,2618,47,0,0,0,0,0,146,1373
6/28/2020,2038,0,0,2618,47,0,0,0,0,0,146,1373
6/29/2020,2039,0,0,2617,47,0,0,0,0,0,146,1373
6/30/2020,2041,0,0,2615,47,0,0,0,0,0,146,1373
7/1/2020,2041,0,0,2615,47,0,0,0,0,0,146,1373
7/2/2020,2042,0,0,2614,47,0,0,0,0,0,146,1373
7/3/2020,2042,0,0,2614,47,0,0,0,0,0,146,1373
7/4/2020,2043,0,0,2613,47,0,0,0,0,0,146,1373
7/5/2020,2044,0,0,2612,47,0,0,0,0,0,146,1373
7/6/2020,2044,0,0,2612,47,0,0,0,0,0,146,1373
7/7/2020,2044,1,0,2611,47,0,1,0,0,0,146,1374
7/8/2020,2046,1,0,2609,47,0,0,0,0,0,146,1374
7/9/2020,2045,2,0,2609,47,0,1,0,0,0,146,1375
7/10/2020,2045,2,0,2609,47,0,0,0,0,0,146,1375
7/11/2020,2045,1,1,2609,47,0,0,0,0,0,146,1375
7/12/2020,2046,1,1,2608,47,0,0,0,0,0,146,1375
7/13/2020,2046,1,1,2608,47,0,0,0,0,0,146,1375
7/14/2020,2046,0,2,2608,47,0,0,0,0,0,146,1375
7/15/2020,2046,1,1,2608,47,0,1,0,0,0,146,1376
7/16/2020,2048,1,1,2606,47,0,0,0,0,0,146,1376
7/17/2020,2048,1,1,2606,47,0,0,0,0,0,146,1376
7/18/2020,2052,1,1,2602,47,0,0,0,0,0,146,1376
7/19/2020,2055,1,1,2599,47,0,0,0,0,0,146,1376
7/20/2020,2058,0,2,2596,47,0,0,0,0,0,146,1376
7/21/2020,2061,0,2,2593,47,0,0,0,0,0,146,1376
7/22/2020,2062,0,2,2592,47,0,0,0,0,0,146,1376
7/23/2020,2065,0,2,2589,47,0,0,0,0,0,146,1376
7/24/2020,2066,0,2,2588,47,0,0,0,0,0,146,1376
7/25/2020,2070,0,2,2584,47,0,0,0,0,0,146,1376
7/26/2020,2072,0,2,2582,47,0,0,1,1,0,147,1376
7/27/2020,2077,0,2,2577,47,0,0,0,1,0,147,1376
7/28/2020,2082,0,2,2572,47,0,0,0,1,0,147,1376
7/29/2020,2083,0,2,2571,47,0,0,0,1,0,147,1376
7/30/2020,2086,0,1,2569,47,0,0,0,1,0,147,1376
7/31/2020,2089,0,1,2566,47,0,0,0,1,0,147,1376
8/1/2020,2091,0,1,2564,47,0,0,0,1,0,147,1376
8/2/2020,2095,0,1,2560,47,0,0,0,1,0,147,1376
8/3/2020,2098,0,1,2557,47,0,0,0,1,0,147,1376
8/4/2020,2102,0,1,2553,47,0,0,0,1,0,147,1376
8/5/2020,2107,0,1,2548,47,0,0,0,1,0,147,1376
8/6/2020,2111,0,1,2544,47,0,0,0,1,0,147,1376
8/7/2020,2111,0,0,2544,48,0,0,0,0,0,147,1376
8/8/2020,2114,0,0,2541,48,0,0,0,0,0,147,1376
8/9/2020,2122,0,0,2533,48,0,0,0,0,0,147,1376
8/10/2020,2124,0,0,2531,48,0,0,0,0,0,147,1376
8/11/2020,2125,0,0,2530,48,0,0,0,0,0,147,1376
8/12/2020,2129,0,0,2526,48,0,0,0,0,0,147,1376
8/13/2020,2134,0,0,2521,48,0,0,0,0,0,147,1376
8/14/2020,2136,0,0,2519,48,0,0,0,0,0,147,1376
8/15/2020,2142,0,0,2513,48,0,0,0,0,0,147,1376
8/16/2020,2147,0,0,2508,48,0,0,0,0,0,147,1376
8/17/2020,2150,0,0,2505,48,0,0,0,0,0,147,1376
8/18/2020,2153,0,0,2502,48,0,0,0,0,0,147,1376
8/19/2020,2155,0,0,2500,48,0,0,0,0,0,147,1376
8/20/2020,2161,0,0,2494,48,0,0,0,0,0,147,1376
8/21/2020,2162,0,0,2493,48,0,0,0,0,0,147,1376
8/22/2020,2167,0,0,2488,48,0,0,0,0,0,147,1376
8/23/2020,2171,0,0,2484,48,0,0,0,0,0,147,1376
8/24/2020,2175,0,0,2480,48,0,0,0,0,0,147,1376
8/25/2020,2181,0,0,2474,48,0,0,0,0,0,147,1376
8/26/2020,2187,0,0,2468,48,0,0,0,0,0,147,1376
8/27/2020,2194,0,0,2461,48,0,0,0,0,0,147,1376
8/28/2020,2198,0,0,2457,48,0,0,0,0,0,147,1376
8/29/2020,2205,0,0,2450,48,0,0,0,0,0,147,1376
8/30/2020,2213,0,0,2442,48,0,0,0,0,0,147,1376
8/31/2020,2215,0,0,2440,48,0,0,0,0,0,147,1376
9/1/2020,2223,0,0,2432,48,0,0,0,0,0,147,1376
9/2/2020,2230,0,0,2425,48,0,0,0,0,0,147,1376
9/3/2020,2235,1,0,2419,48,0,1,0,0,0,147,1377
9/4/2020,2240,1,0,2414,48,0,0,0,0,0,147,1377
9/5/2020,2246,1,0,2408,48,0,0,0,0,0,147,1377
9/6/2020,2250,0,1,2404,48,0,0,0,0,0,147,1377
9/7/2020,2254,0,1,2400,48,0,0,0,0,0,147,1377
9/8/2020,2262,0,0,2393,48,0,0,0,0,0,147,1377
9/9/2020,2270,0,0,2385,48,0,0,0,0,0,147,1377
9/10/2020,2275,0,0,2380,48,0,0,0,0,0,147,1377
9/11/2020,2280,0,0,2375,48,0,0,0,0,0,147,1377
9/12/2020,2285,0,0,2370,48,0,0,0,0,0,147,1377
9/13/2020,2294,0,0,2361,48,0,0,0,0,0,147,1377
9/14/2020,2302,0,0,2353,48,0,0,0,0,0,147,1377
9/15/2020,2310,1,0,2344,48,0,1,0,0,0,147,1378
9/16/2020,2317,1,0,2337,48,0,0,0,0,0,147,1378
9/17/2020,2333,1,1,2320,48,0,1,0,0,0,147,1379
9/18/2020,2345,1,2,2307,48,0,1,0,0,0,147,1380
9/19/2020,2354,1,2,2298,48,0,0,0,0,0,147,1380
9/20/2020,2361,1,2,2291,48,0,0,0,0,0,147,1380
9/21/2020,2370,2,2,2281,48,0,1,0,0,0,147,1381
9/22/2020,2385,1,3,2266,48,0,0,0,0,0,147,1381
9/23/2020,2391,2,3,2259,48,0,1,0,0,0,147,1382
9/24/2020,2399,2,3,2251,48,0,0,0,0,0,147,1382
9/25/2020,2409,1,2,2243,48,0,0,0,0,0,147,1382
9/26/2020,2413,1,2,2239,48,0,0,0,0,0,147,1382
9/27/2020,2421,2,1,2231,48,0,1,0,0,0,147,1383
9/28/2020,2433,1,2,2219,48,0,0,0,0,0,147,1383
9/29/2020,2440,2,2,2211,48,0,1,0,0,0,147,1384
9/30/2020,2447,2,2,2204,48,0,0,0,0,0,147,1384
10/1/2020,2466,1,2,2186,48,0,0,0,0,0,147,1384
10/2/2020,2481,1,2,2171,48,0,0,0,0,0,147,1384
10/3/2020,2492,3,2,2158,48,0,2,0,0,0,147,1386
10/4/2020,2501,3,2,2149,48,0,0,1,1,0,148,1386
10/5/2020,2516,2,3,2134,48,0,0,0,1,0,148,1386
10/6/2020,2527,2,3,2123,48,0,0,0,1,0,148,1386
10/7/2020,2540,2,4,2109,48,0,1,0,1,0,148,1387
10/8/2020,2557,2,3,2093,48,0,0,0,1,0,148,1387
10/9/2020,2572,1,4,2078,48,0,0,0,1,0,148,1387
10/10/2020,2579,1,3,2072,48,0,0,1,2,0,149,1387
10/11/2020,2590,3,2,2060,48,0,2,0,2,0,149,1389
10/12/2020,2594,2,3,2056,48,0,0,0,2,0,149,1389
10/13/2020,2609,0,5,2041,48,0,0,0,2,0,149,1389
10/14/2020,2627,1,5,2022,48,0,1,0,2,0,149,1390
10/15/2020,2639,1,6,2009,48,0,1,0,2,0,149,1391
10/16/2020,2645,3,4,2002,49,0,2,0,1,0,149,1393
10/17/2020,2652,4,4,1994,49,0,1,0,1,0,149,1394
10/18/2020,2668,3,5,1978,49,0,0,0,1,0,149,1394
10/19/2020,2678,3,5,1968,49,0,0,0,1,0,149,1394
10/20/2020,2689,2,5,1958,49,0,0,0,1,0,149,1394
10/21/2020,2704,1,5,1944,49,0,0,0,1,0,149,1394
10/22/2020,2715,0,6,1933,49,0,0,0,1,0,149,1394
10/23/2020,2725,0,6,1923,49,0,0,0,1,0,149,1394
10/24/2020,2736,1,3,1914,49,0,1,0,1,0,149,1395
10/25/2020,2745,1,2,1906,49,0,0,0,1,0,149,1395
10/26/2020,2759,1,1,1892,50,0,0,0,0,0,149,1395
10/27/2020,2769,1,0,1883,50,0,0,0,0,0,149,1395
10/28/2020,2781,1,0,1871,50,0,0,0,0,0,149,1395
10/29/2020,2793,1,0,1859,50,0,0,0,0,0,149,1395
10/30/2020,2803,1,0,1849,50,0,0,0,0,0,149,1395
10/31/2020,2819,0,1,1833,50,0,0,0,0,0,149,1395
11/1/2020,2835,1,0,1817,50,0,1,0,0,0,149,1396
11/2/2020,2850,1,0,1802,50,0,0,0,0,0,149,1396
11/3/2020,2858,1,0,1794,50,0,0,0,0,0,149,1396
11/4/2020,2865,1,0,1787,50,0,0,0,0,0,149,1396
11/5/2020,2878,2,0,1773,50,0,1,0,0,0,149,1397
11/6/2020,2899,2,0,1752,50,0,0,0,0,0,149,1397
11/7/2020,2914,1,1,1737,50,0,0,0,0,0,149,1397
11/8/2020,2933,1,0,1719,50,0,0,0,0,0,149,1397
11/9/2020,2954,1,0,1698,50,0,0,0,0,0,149,1397
11/10/2020,2969,1,0,1683,50,0,0,0,0,0,149,1397
11/11/2020,2985,1,0,1667,50,0,0,0,0,0,149,1397
11/12/2020,3005,1,1,1646,50,0,1,0,0,0,149,1398
11/13/2020,3012,2,1,1638,50,0,1,0,0,0,149,1399
11/14/2020,3026,1,2,1624,50,0,0,0,0,0,149,1399
11/15/2020,3039,1,2,1611,50,0,0,0,0,0,149,1399
11/16/2020,3056,1,3,1593,50,0,1,0,0,0,149,1400
11/17/2020,3065,2,3,1583,50,0,1,0,0,0,149,1401
11/18/2020,3081,3,3,1566,50,0,1,0,0,0,149,1402
11/19/2020,3102,3,2,1546,50,0,0,0,0,0,149,1402
11/20/2020,3120,2,2,1529,50,0,0,0,0,0,149,1402
11/21/2020,3138,2,2,1511,50,0,0,0,0,0,149,1402
11/22/2020,3150,2,2,1499,50,0,0,0,0,0,149,1402
11/23/2020,3163,1,3,1486,50,0,0,0,0,0,149,1402
11/24/2020,3184,1,1,1467,50,0,0,0,0,0,149,1402
11/25/2020,3203,0,2,1448,50,0,0,0,0,0,149,1402
11/26/2020,3217,1,2,1433,50,0,1,0,0,0,149,1403
11/27/2020,3229,0,3,1421,50,0,0,0,0,0,149,1403
11/28/2020,3249,0,3,1401,50,0,0,0,0,0,149,1403
11/29/2020,3265,0,2,1386,50,0,0,0,0,0,149,1403
11/30/2020,3280,0,2,1371,50,0,0,0,0,0,149,1403
12/1/2020,3292,1,1,1359,50,0,1,0,0,0,149,1404
12/2/2020,3308,1,1,1343,50,0,0,0,0,0,149,1404
12/3/2020,3324,2,1,1326,50,0,1,0,0,0,149,1405
12/4/2020,3343,1,2,1307,50,0,0,0,0,0,149,1405
12/5/2020,3361,2,2,1288,50,0,1,0,0,0,149,1406
12/6/2020,3378,2,2,1271,50,0,0,0,0,0,149,1406
12/7/2020,3398,3,1,1251,50,0,2,0,0,0,149,1408
12/8/2020,3418,2,2,1231,50,0,0,0,0,0,149,1408
12/9/2020,3431,2,2,1218,50,0,0,0,0,0,149,1408
12/10/2020,3447,2,2,1202,50,0,0,0,0,0,149,1408
12/11/2020,3463,1,3,1186,50,0,0,0,0,0,149,1408
12/12/2020,3478,1,3,1171,50,0,0,0,0,0,149,1408
12/13/2020,3491,0,4,1158,50,0,0,0,0,0,149,1408
12/14/2020,3500,1,3,1149,50,0,1,0,0,0,149,1409
12/15/2020,3511,0,2,1140,50,0,0,0,0,0,149,1409
12/16/2020,3524,0,2,1127,50,0,0,0,0,0,149,1409
12/17/2020,3538,0,1,1114,50,0,0,0,0,0,149,1409
12/18/2020,3549,0,1,1103,50,0,0,0,0,0,149,1409
12/19/2020,3562,0,1,1090,50,0,0,0,0,0,149,1409
12/20/2020,3579,0,1,1073,50,0,0,0,0,0,149,1409
12/21/2020,3595,0,1,1057,50,0,0,0,0,0,149,1409
12/22/2020,3602,0,1,1050,50,0,0,0,0,0,149,1409
12/23/2020,3359,0,0,1033,50,261,0,0,0,0,149,1409
12/24/2020,3310,0,0,1026,50,317,0,0,0,0,149,1409
12/25/2020,3232,1,0,1011,50,409,1,0,0,0,149,1410
12/26/2020,3156,1,0,1000,50,496,0,0,0,0,149,1410
12/27/2020,3079,1,0,984,50,589,0,0,0,0,149,1410
12/28/2020,2996,1,0,976,50,680,0,0,0,0,149,1410
12/29/2020,2905,0,1,966,50,781,0,0,0,0,149,1410
12/30/2020,2824,0,1,954,50,874,0,0,0,0,149,1410
12/31/2020,2748,0,1,943,50,961,0,0,0,0,149,1410
1/1/2021,2670,1,1,935,50,1046,1,0,0,0,149,1411
1/2/2021,2718,1,1,924,50,1009,0,0,0,0,149,1411
1/3/2021,2752,1,1,905,50,994,0,0,0,0,149,1411
1/4/2021,2779,1,0,900,50,973,0,0,0,0,149,1411
1/5/2021,2801,0,1,889,50,962,0,0,0,0,149,1411
1/6/2021,2811,0,1,880,50,961,0,0,0,0,149,1411
1/7/2021,2826,0,1,869,50,957,0,0,0,0,149,1411
1/8/2021,2828,0,1,856,50,968,0,0,0,0,149,1411
1/9/2021,2841,0,0,842,50,970,0,0,0,0,149,1411
1/10/2021,2853,0,0,830,50,970,0,0,0,0,149,1411
1/11/2021,2862,0,0,823,50,968,0,0,0,0,149,1411
1/12/2021,2868,0,0,808,50,977,0,0,0,0,149,1411
1/13/2021,2871,0,0,799,50,983,0,0,0,0,149,1411
1/14/2021,2881,0,0,785,50,987,0,0,0,0,149,1411
1/15/2021,2890,0,0,768,50,995,0,0,0,0,149,1411
1/16/2021,2898,0,0,755,50,1000,0,0,0,0,149,1411
1/17/2021,2900,0,0,748,50,1005,0,0,0,0,149,1411
1/18/2021,2904,0,0,741,50,1008,0,0,0,0,149,1411
1/19/2021,2908,0,0,731,50,1014,0,0,0,0,149,1411
1/20/2021,2910,0,0,723,50,1020,0,0,0,0,149,1411
1/21/2021,2913,0,0,713,50,1027,0,0,0,0,149,1411
1/22/2021,2920,0,0,701,50,1032,0,0,0,0,149,1411
1/23/2021,2922,0,0,696,50,1035,0,0,0,0,149,1411
1/24/2021,2927,2,0,686,50,1038,2,0,0,0,149,1413
1/25/2021,2932,2,0,676,50,1043,0,0,0,0,149,1413
1/26/2021,2937,2,0,664,50,1050,0,0,0,0,149,1413
1/27/2021,2939,2,0,658,50,1054,0,0,0,0,149,1413
1/28/2021,2943,2,0,652,50,1056,0,0,0,0,149,1413
1/29/2021,2949,1,1,642,50,1060,0,0,0,0,149,1413
1/30/2021,2950,0,1,636,50,1066,0,0,0,0,149,1413
1/31/2021,2955,0,1,622,50,1075,0,0,0,0,149,1413
2/1/2021,2961,0,1,611,50,1080,0,0,0,0,149,1413
2/2/2021,2962,0,1,605,50,1085,0,0,0,0,149,1413
2/3/2021,2966,1,0,599,50,1087,1,0,0,0,149,1414
2/4/2021,2975,1,0,587,50,1090,0,0,0,0,149,1414
2/5/2021,2978,1,1,573,50,1100,1,0,0,0,149,1415
2/6/2021,2979,2,1,564,50,1107,1,0,0,0,149,1416
2/7/2021,2984,2,1,552,50,1114,0,0,0,0,149,1416
2/8/2021,2992,2,0,541,50,1118,0,0,0,0,149,1416
2/9/2021,2992,2,0,531,50,1128,0,0,0,0,149,1416
2/10/2021,2996,1,1,522,50,1133,0,0,0,0,149,1416
2/11/2021,2998,0,2,518,50,1135,0,0,0,0,149,1416
2/12/2021,3001,0,2,513,50,1137,0,0,0,0,149,1416
2/13/2021,3003,0,1,505,50,1144,0,0,0,0,149,1416
2/14/2021,3008,1,1,496,50,1147,1,0,0,0,149,1417
2/15/2021,3012,1,1,489,50,1150,0,0,0,0,149,1417
2/16/2021,3017,1,1,480,50,1154,0,0,0,0,149,1417
2/17/2021,3022,1,1,473,50,1156,0,0,0,0,149,1417
2/18/2021,3024,1,0,469,50,1159,0,0,0,0,149,1417
2/19/2021,3028,0,1,463,50,1161,0,0,0,0,149,1417
2/20/2021,3029,0,1,455,50,1168,0,0,0,0,149,1417
2/21/2021,3031,0,1,451,50,1170,0,0,0,0,149,1417
2/22/2021,3037,0,1,442,50,1173,0,0,0,0,149,1417
2/23/2021,3037,0,0,440,50,1176,0,0,0,0,149,1417
2/24/2021,3042,0,0,434,50,1177,0,0,0,0,149,1417
2/25/2021,3047,0,0,426,50,1180,0,0,0,0,149,1417
2/26/2021,3052,0,0,418,50,1183,0,0,0,0,149,1417
2/27/2021,3058,0,0,408,50,1187,0,0,0,0,149,1417
2/28/2021,3061,0,0,403,50,1189,0,0,0,0,149,1417
3/1/2021,3062,1,0,400,50,1190,1,0,0,0,149,1418
3/2/2021,3069,1,0,392,50,1191,0,0,0,0,149,1418
3/3/2021,3075,0,1,384,50,1193,0,0,0,0,149,1418
3/4/2021,3080,0,1,377,50,1195,0,0,0,0,149,1418
3/5/2021,3082,0,1,375,50,1195,0,0,0,0,149,1418
3/6/2021,3088,0,1,368,50,1196,0,0,0,0,149,1418
3/7/2021,3094,0,1,360,50,1198,0,0,0,0,149,1418
3/8/2021,3096,0,1,353,50,1203,0,0,0,0,149,1418
3/9/2021,3102,0,1,344,50,1206,0,0,0,0,149,1418
3/10/2021,3108,0,1,335,50,1209,0,0,0,0,149,1418
3/11/2021,3112,0,1,329,50,1211,0,0,0,0,149,1418
3/12/2021,3114,0,1,325,50,1213,0,0,0,0,149,1418
3/13/2021,3120,0,1,317,50,1215,0,0,0,0,149,1418
3/14/2021,3122,0,1,310,50,1220,0,0,0,0,149,1418
3/15/2021,3126,0,1,306,50,1220,0,0,0,0,149,1418
3/16/2021,3130,0,1,300,50,1222,0,0,0,0,149,1418
3/17/2021,3133,0,1,293,50,1226,0,0,0,0,149,1418
3/18/2021,3135,0,1,290,50,1227,0,0,0,0,149,1418
3/19/2021,3137,0,0,287,50,1229,0,0,0,0,149,1418
3/20/2021,3143,0,0,280,50,1230,0,0,0,0,149,1418
3/21/2021,3148,0,0,274,50,1231,0,0,0,0,149,1418
3/22/2021,3154,0,0,266,50,1233,0,0,0,0,149,1418
3/23/2021,3157,0,0,261,50,1235,0,0,0,0,149,1418
3/24/2021,3158,0,0,260,50,1235,0,0,0,0,149,1418
3/25/2021,3162,0,0,256,50,1235,0,0,0,0,149,1418
3/26/2021,3170,0,0,246,50,1237,0,0,0,0,149,1418
3/27/2021,3174,0,0,238,50,1241,0,0,0,0,149,1418
3/28/2021,3178,1,0,233,50,1241,1,0,0,0,149,1419
3/29/2021,3179,1,0,225,50,1248,0,0,0,0,149,1419
3/30/2021,3183,1,0,221,50,1248,0,0,0,0,149,1419
3/31/2021,3185,2,0,218,50,1248,1,0,0,0,149,1420
4/1/2021,3189,2,0,210,50,1252,0,0,0,0,149,1420
4/2/2021,3191,3,0,207,50,1252,1,0,0,0,149,1421
4/3/2021,3194,2,1,203,50,1253,0,0,0,0,149,1421
4/4/2021,3194,2,1,200,50,1256,0,0,0,0,149,1421
4/5/2021,3196,1,1,199,50,1256,0,0,0,0,149,1421
4/6/2021,3196,0,2,198,50,1257,0,0,0,0,149,1421
4/7/2021,3199,0,2,194,50,1258,0,0,0,0,149,1421
4/8/2021,3201,0,2,191,50,1259,0,0,0,0,149,1421
4/9/2021,3203,0,1,189,50,1260,0,0,0,0,149,1421
4/10/2021,3205,0,1,185,50,1262,0,0,0,0,149,1421
4/11/2021,3207,0,1,180,50,1265,0,0,0,0,149,1421
4/12/2021,3208,0,1,177,50,1267,0,0,0,0,149,1421
4/13/2021,3207,1,1,177,50,1267,1,0,0,0,149,1422
4/14/2021,3210,1,0,175,50,1267,0,0,0,0,149,1422
4/15/2021,3212,1,0,173,50,1267,0,0,0,0,149,1422
4/16/2021,3218,1,0,168,50,1266,0,0,0,0,149,1422
4/17/2021,3219,1,0,167,50,1266,0,0,0,0,149,1422
4/18/2021,3221,1,0,164,50,1267,0,0,0,0,149,1422
4/19/2021,3224,1,0,161,50,1267,0,0,0,0,149,1422
4/20/2021,3225,0,1,159,50,1268,0,0,0,0,149,1422
4/21/2021,3227,0,1,157,50,1268,0,0,0,0,149,1422
4/22/2021,3228,0,0,156,50,1269,0,0,0,0,149,1422
4/23/2021,3231,0,0,153,50,1269,0,0,0,0,149,1422
4/24/2021,3232,0,0,149,50,1272,0,0,0,0,149,1422
4/25/2021,3235,1,0,145,50,1272,1,0,0,0,149,1423
4/26/2021,3234,2,0,144,50,1273,1,0,0,0,149,1424
4/27/2021,3235,2,0,141,50,1275,0,0,0,0,149,1424
4/28/2021,3236,2,0,140,50,1275,0,0,0,0,149,1424
4/29/2021,3235,3,0,140,50,1275,1,0,0,0,149,1425
4/30/2021,3235,2,1,140,50,1275,0,0,0,0,149,1425
5/1/2021,3236,1,2,139,50,1275,0,0,0,0,149,1425
5/2/2021,3237,2,2,137,50,1275,1,0,0,0,149,1426
5/3/2021,3238,1,2,138,50,1274,0,0,0,0,149,1426
5/4/2021,3238,1,2,138,50,1274,0,0,0,0,149,1426
5/5/2021,3240,0,2,136,50,1275,0,0,0,0,149,1426
5/6/2021,3243,0,1,133,50,1276,0,0,0,0,149,1426
5/7/2021,3245,0,1,131,50,1276,0,0,0,0,149,1426
5/8/2021,3246,0,1,130,50,1276,0,0,0,0,149,1426
5/9/2021,3247,1,1,128,50,1276,1,0,0,0,149,1427
5/10/2021,3250,0,1,126,50,1276,0,0,0,0,149,1427
5/11/2021,3252,0,1,124,50,1276,0,0,0,0,149,1427
5/12/2021,3255,0,1,121,50,1276,0,0,0,0,149,1427
5/13/2021,3258,1,1,119,50,1274,1,0,0,0,149,1428
5/14/2021,3258,1,1,119,50,1274,0,0,0,0,149,1428
5/15/2021,3261,1,1,118,50,1272,0,0,0,0,149,1428
5/16/2021,3262,0,2,118,50,1271,0,0,0,0,149,1428
5/17/2021,3262,1,2,116,50,1272,1,0,0,0,149,1429
5/18/2021,3265,1,1,115,50,1271,0,0,0,0,149,1429
5/19/2021,3267,1,2,113,50,1270,1,0,0,0,149,1430
5/20/2021,3272,2,2,110,50,1267,1,0,0,0,149,1431
5/21/2021,3273,2,1,109,50,1268,0,0,0,0,149,1431
5/22/2021,3275,3,1,105,50,1269,1,0,0,0,149,1432
5/23/2021,3276,3,2,102,50,1270,1,0,0,0,149,1433
5/24/2021,3274,5,1,103,50,1270,2,0,0,0,149,1435
5/25/2021,3275,3,2,104,50,1269,0,0,0,0,149,1435
5/26/2021,3276,3,2,103,50,1269,0,0,0,0,149,1435
5/27/2021,3277,3,2,103,50,1268,0,0,0,0,149,1435
5/28/2021,3283,1,3,102,50,1264,0,0,0,0,149,1435
5/29/2021,3286,1,2,100,50,1264,0,0,0,0,149,1435
5/30/2021,3286,1,2,99,50,1265,0,0,0,0,149,1435
5/31/2021,3286,1,2,99,50,1265,0,0,0,0,149,1435
6/1/2021,3286,0,2,99,50,1266,0,0,0,0,149,1435
6/2/2021,3288,0,0,100,50,1265,0,0,0,0,149,1435
6/3/2021,3289,1,0,100,50,1263,1,0,0,0,149,1436
6/4/2021,3291,1,1,99,50,1261,1,0,0,0,149,1437
6/5/2021,3294,1,1,97,50,1260,0,0,0,0,149,1437
6/6/2021,3296,1,1,96,50,1259,0,0,0,0,149,1437
6/7/2021,3297,1,2,96,50,1257,1,0,0,0,149,1438
6/8/2021,3298,1,2,94,50,1258,0,0,0,0,149,1438
6/9/2021,3299,2,1,95,50,1256,1,0,0,0,149,1439
6/10/2021,3303,1,2,92,50,1255,0,0,0,0,149,1439
6/11/2021,3304,2,1,92,50,1254,1,0,0,0,149,1440
6/12/2021,3303,3,1,92,50,1254,1,0,0,0,149,1441
6/13/2021,3305,3,1,91,50,1253,0,0,0,0,149,1441
6/14/2021,3306,3,1,91,50,1252,0,0,0,0,149,1441
6/15/2021,3307,4,1,91,50,1250,1,0,0,0,149,1442
6/16/2021,3308,3,2,90,50,1250,0,0,0,0,149,1442
6/17/2021,3310,1,3,88,50,1251,0,0,0,0,149,1442
6/18/2021,3312,0,4,88,50,1249,0,0,0,0,149,1442
6/19/2021,3313,0,4,87,50,1249,0,0,0,0,149,1442
6/20/2021,3313,0,4,87,50,1249,0,0,0,0,149,1442
6/21/2021,3313,1,3,88,50,1248,1,0,0,0,149,1443
6/22/2021,3314,2,1,89,50,1247,1,0,0,0,149,1444
6/23/2021,3316,2,1,89,50,1245,0,0,0,0,149,1444
6/24/2021,3319,2,2,88,50,1242,1,0,0,0,149,1445
6/25/2021,3322,3,1,89,50,1238,1,0,0,0,149,1446
6/26/2021,3323,2,3,89,50,1236,1,0,0,0,149,1447
6/27/2021,3325,2,2,90,50,1234,0,0,0,0,149,1447
6/28/2021,3327,2,2,90,50,1232,1,0,0,0,149,1448
6/29/2021,3325,4,2,90,50,1232,2,0,0,0,149,1450
6/30/2021,3328,4,2,91,50,1228,1,0,0,0,149,1451
7/1/2021,3329,6,1,92,50,1225,2,0,0,0,149,1453
7/2/2021,3330,5,4,92,50,1222,2,0,0,0,149,1455
7/3/2021,3335,5,4,91,50,1218,1,0,0,0,149,1456
7/4/2021,3336,7,3,90,50,1217,2,0,0,0,149,1458
7/5/2021,3340,4,6,90,50,1213,0,0,0,0,149,1458
7/6/2021,3339,5,5,92,50,1212,2,0,0,0,149,1460
7/7/2021,3340,5,5,92,50,1211,1,0,0,0,149,1461
7/8/2021,3341,5,6,92,50,1209,1,0,0,0,149,1462
7/9/2021,3344,4,8,90,50,1207,1,0,0,0,149,1463
7/10/2021,3349,4,6,90,50,1204,0,0,0,0,149,1463
7/11/2021,3354,3,7,91,50,1198,1,0,0,0,149,1464
7/12/2021,3358,1,7,92,50,1195,0,0,0,0,149,1464
7/13/2021,3362,1,5,93,50,1192,0,0,0,0,149,1464
7/14/2021,3363,2,4,94,50,1190,1,0,0,0,149,1465
7/15/2021,3366,2,5,93,50,1187,1,0,0,0,149,1466
7/16/2021,3369,1,4,95,50,1184,0,0,0,0,149,1466
7/17/2021,3371,1,3,95,50,1183,0,0,0,0,149,1466
7/18/2021,3374,2,3,95,50,1179,1,0,0,0,149,1467
7/19/2021,3376,2,1,97,50,1177,0,0,0,0,149,1467
7/20/2021,3381,1,1,98,50,1172,0,0,0,0,149,1467
7/21/2021,3382,0,2,98,50,1171,0,0,0,0,149,1467
7/22/2021,3388,1,1,99,50,1164,1,0,0,0,149,1468
7/23/2021,3394,1,1,98,50,1159,0,0,0,0,149,1468
7/24/2021,3400,1,1,98,50,1153,0,0,0,0,149,1468
7/25/2021,3406,3,1,96,50,1147,2,0,0,0,149,1470
7/26/2021,3408,2,1,96,50,1146,0,0,0,0,149,1470
7/27/2021,3412,2,2,94,50,1143,1,0,0,0,149,1471
7/28/2021,3415,2,2,93,50,1141,0,0,0,0,149,1471
7/29/2021,3420,1,3,92,50,1137,0,0,0,0,149,1471
7/30/2021,3421,1,3,92,50,1136,0,0,0,0,149,1471
7/31/2021,3426,1,3,92,50,1131,0,0,0,0,149,1471
8/1/2021,3431,0,4,92,50,1126,0,0,0,0,149,1471
8/2/2021,3433,0,4,90,50,1126,0,0,0,0,149,1471
8/3/2021,3438,1,4,90,50,1120,1,0,0,0,149,1472
8/4/2021,3439,1,4,90,50,1119,0,0,0,0,149,1472
8/5/2021,3443,0,1,93,50,1116,0,0,0,0,149,1472
8/6/2021,3446,0,1,92,50,1114,0,0,0,0,149,1472
8/7/2021,3447,1,1,91,50,1113,1,0,0,0,149,1473
8/8/2021,3449,1,1,91,50,1111,0,0,0,0,149,1473
8/9/2021,3451,0,2,91,50,1109,0,0,0,0,149,1473
8/10/2021,3455,0,2,91,50,1105,0,0,0,0,149,1473
8/11/2021,3458,0,1,92,50,1102,0,0,0,0,149,1473
8/12/2021,3463,1,1,91,50,1097,1,0,0,0,149,1474
8/13/2021,3467,1,1,91,50,1093,0,0,0,0,149,1474
8/14/2021,3469,1,1,91,50,1091,0,0,0,0,149,1474
8/15/2021,3472,2,0,91,50,1088,1,0,0,0,149,1475
8/16/2021,3477,2,0,91,50,1083,0,0,0,0,149,1475
8/17/2021,3480,1,1,91,50,1080,0,0,0,0,149,1475
8/18/2021,3486,1,1,90,50,1075,0,0,0,0,149,1475
8/19/2021,3488,0,2,90,50,1073,0,0,0,0,149,1475
8/20/2021,3495,1,2,90,50,1065,1,0,0,0,149,1476
8/21/2021,3500,1,1,91,50,1060,0,0,0,0,149,1476
8/22/2021,3500,1,1,91,50,1060,0,0,0,0,149,1476
8/23/2021,3501,2,1,91,50,1058,1,0,0,0,149,1477
8/24/2021,3504,1,2,91,50,1055,0,0,0,0,149,1477
8/25/2021,3508,1,2,92,50,1050,1,0,0,0,149,1478
8/26/2021,3513,3,2,92,50,1043,2,0,0,0,149,1480
8/27/2021,3521,3,1,93,50,1035,0,0,0,0,149,1480
8/28/2021,3525,2,2,92,50,1032,0,0,0,0,149,1480
8/29/2021,3530,1,3,90,50,1029,0,0,0,0,149,1480
8/30/2021,3531,2,3,90,50,1027,1,0,0,0,149,1481
8/31/2021,3534,3,3,90,50,1023,1,0,0,0,149,1482
9/1/2021,3537,3,2,90,50,1021,0,0,0,0,149,1482
9/2/2021,3539,2,3,90,50,1019,0,0,0,0,149,1482
9/3/2021,3546,2,2,92,50,1011,1,0,0,0,149,1483
9/4/2021,3552,4,2,92,50,1003,2,0,0,0,149,1485
9/5/2021,3554,3,5,92,50,999,2,0,0,0,149,1487
9/6/2021,3555,1,6,93,50,998,0,0,0,0,149,1487
9/7/2021,3556,2,6,93,50,996,1,0,0,0,149,1488
9/8/2021,3564,5,6,93,50,985,3,0,0,0,149,1491
9/9/2021,3570,5,6,94,50,978,1,0,0,0,149,1492
9/10/2021,3572,3,7,95,50,976,0,0,0,0,149,1492
9/11/2021,3577,3,5,96,50,972,0,0,0,0,149,1492
9/12/2021,3587,3,3,98,50,962,1,0,0,0,149,1493
9/13/2021,3591,3,4,97,50,958,1,0,0,0,149,1494
9/14/2021,3598,2,5,98,50,950,1,0,0,0,149,1495
9/15/2021,3603,2,4,99,50,945,0,0,0,0,149,1495
9/16/2021,3607,2,4,99,50,941,0,0,0,0,149,1495
9/17/2021,3610,3,3,100,50,937,1,0,0,0,149,1496
9/18/2021,3611,3,1,102,50,936,0,0,0,0,149,1496
9/19/2021,3614,2,2,102,50,933,0,0,0,0,149,1496
9/20/2021,3617,2,1,101,50,932,0,0,0,0,149,1496
9/21/2021,3621,1,2,101,50,928,0,0,0,0,149,1496
9/22/2021,3624,1,2,101,50,925,0,0,0,0,149,1496
9/23/2021,3628,1,3,100,50,921,1,0,0,0,149,1497
9/24/2021,3631,2,2,101,50,917,1,0,0,0,149,1498
9/25/2021,3635,2,2,100,50,914,1,0,0,0,149,1499
9/26/2021,3643,2,2,100,50,906,0,0,0,0,149,1499
9/27/2021,3641,4,1,101,50,906,2,0,0,0,149,1501
9/28/2021,3644,3,2,101,50,903,0,0,0,0,149,1501
9/29/2021,3649,3,3,100,50,898,1,0,0,0,149,1502
9/30/2021,3653,3,3,100,50,894,0,0,0,0,149,1502
10/1/2021,3658,3,4,99,50,889,1,0,0,0,149,1503
10/2/2021,3665,5,3,99,50,881,2,0,0,0,149,1505
10/3/2021,3672,5,3,97,50,876,0,0,0,0,149,1505
10/4/2021,3673,6,3,97,50,874,1,0,0,0,149,1506
10/5/2021,3675,3,6,98,50,871,1,0,0,0,149,1507
10/6/2021,3676,6,4,100,50,867,3,0,0,0,149,1510
10/7/2021,3681,5,4,102,50,861,1,0,0,0,149,1511
10/8/2021,3684,7,3,103,50,856,2,0,0,0,149,1513
10/9/2021,3686,7,4,103,50,853,2,0,0,0,149,1515
10/10/2021,3688,5,7,104,50,849,2,0,0,0,149,1517
10/11/2021,3689,7,7,104,50,846,2,0,0,0,149,1519
10/12/2021,3686,8,9,104,50,846,3,0,0,0,149,1522
10/13/2021,3690,7,8,106,50,842,0,0,0,0,149,1522
10/14/2021,3696,7,9,107,50,834,2,0,0,0,149,1524
10/15/2021,3697,9,11,107,50,829,4,0,0,0,149,1528
10/16/2021,3694,12,10,108,50,829,4,0,0,0,149,1532
10/17/2021,3692,14,9,112,50,826,5,0,0,0,149,1537
10/18/2021,3695,13,7,114,50,824,0,0,0,0,149,1537
10/19/2021,3695,11,8,117,50,822,2,0,0,0,149,1539
10/20/2021,3698,9,8,119,50,819,0,0,0,0,149,1539
10/21/2021,3699,9,9,121,50,815,3,0,0,0,149,1542
10/22/2021,3702,6,11,121,50,813,0,0,0,0,149,1542
10/23/2021,3705,4,13,122,50,809,1,0,0,0,149,1543
10/24/2021,3710,4,11,124,50,804,0,0,0,0,149,1543
10/25/2021,3710,7,11,123,50,802,4,0,0,0,149,1547
10/26/2021,3712,7,11,124,50,799,1,0,0,0,149,1548
10/27/2021,3715,12,9,125,50,792,5,0,0,0,149,1553
10/28/2021,3719,11,6,129,50,788,0,0,0,0,149,1553
10/29/2021,3720,8,8,131,50,786,1,0,0,0,149,1554
10/30/2021,3719,5,10,134,50,785,2,0,0,0,149,1556
10/31/2021,3719,8,11,135,50,780,5,0,0,0,149,1561
11/1/2021,3720,8,10,137,50,778,1,0,0,0,149,1562
11/2/2021,3723,9,7,140,50,774,1,0,0,0,149,1563
11/3/2021,3723,8,10,140,50,772,3,0,0,0,149,1566
11/4/2021,3724,7,12,140,50,770,2,0,0,0,149,1568
11/5/2021,3725,7,12,142,50,767,2,0,0,0,149,1570
11/6/2021,3727,9,10,144,50,763,2,0,0,0,149,1572
11/7/2021,3728,7,12,146,50,760,3,0,0,0,149,1575
11/8/2021,3724,11,11,149,50,758,6,0,0,0,149,1581
11/9/2021,3729,11,9,152,50,752,1,0,0,0,149,1582
11/10/2021,3728,11,11,153,50,750,3,0,0,0,149,1585
11/11/2021,3727,11,12,154,50,749,2,0,0,0,149,1587
11/12/2021,3727,9,10,160,50,747,2,0,0,0,149,1589
11/13/2021,3727,5,14,160,50,747,0,0,0,0,149,1589
11/14/2021,3728,7,14,160,50,744,2,0,0,0,149,1591
11/15/2021,3731,8,12,162,50,740,2,0,0,0,149,1593
11/16/2021,3733,7,12,163,50,738,0,0,0,0,149,1593
11/17/2021,3732,8,11,165,50,737,3,0,0,0,149,1596
11/18/2021,3732,9,9,168,50,735,2,0,0,0,149,1598
11/19/2021,3731,7,9,171,50,735,1,0,0,0,149,1599
11/20/2021,3730,4,12,172,50,735,1,0,0,0,149,1600
11/21/2021,3731,5,12,172,50,733,2,0,0,0,149,1602
11/22/2021,3732,7,9,174,50,731,2,0,0,0,149,1604
11/23/2021,3732,8,9,174,50,730,1,0,0,0,149,1605
11/24/2021,3735,5,12,174,50,727,1,0,0,0,149,1606
11/25/2021,3737,3,13,174,50,726,0,0,0,0,149,1606
11/26/2021,3733,7,12,176,50,725,5,0,0,0,149,1611
11/27/2021,3733,8,10,178,50,724,1,0,0,0,149,1612
11/28/2021,3733,9,9,180,50,722,2,0,0,0,149,1614
11/29/2021,3731,10,10,180,50,722,3,0,0,0,149,1617
11/30/2021,3729,11,11,182,50,720,4,0,0,0,149,1621
12/1/2021,3726,11,11,186,50,719,4,0,0,0,149,1625
12/2/2021,3725,11,11,190,50,716,4,0,0,0,149,1629
12/3/2021,3723,14,10,192,50,714,4,0,0,0,149,1633
12/4/2021,3721,14,12,192,50,714,2,0,0,0,149,1635
12/5/2021,3721,11,17,191,50,713,2,0,0,0,149,1637
12/6/2021,3721,13,15,192,50,712,3,0,0,0,149,1640
12/7/2021,3718,15,17,194,50,709,6,0,0,0,149,1646
12/8/2021,3721,12,16,199,50,705,1,0,0,0,149,1647
12/9/2021,3717,13,15,203,50,705,4,0,0,0,149,1651
12/10/2021,3714,15,15,205,50,704,4,0,0,0,149,1655
12/11/2021,3713,14,15,208,49,704,3,0,0,0,149,1658
12/12/2021,3712,13,15,211,49,703,2,0,0,0,149,1660
12/13/2021,3708,15,13,215,49,703,4,0,0,0,149,1664
12/14/2021,3707,10,15,219,49,703,1,0,0,0,149,1665
12/15/2021,3708,8,17,220,49,701,2,0,0,0,149,1667
12/16/2021,3708,5,19,223,49,699,2,0,0,0,149,1669
12/17/2021,3710,6,17,226,49,695,2,0,0,0,149,1671
12/18/2021,3709,7,18,227,49,693,3,0,0,0,149,1674
12/19/2021,3708,10,17,228,49,691,3,0,0,0,149,1677
12/20/2021,3706,11,15,233,49,689,5,0,0,0,149,1682
12/21/2021,3709,8,16,235,49,686,0,0,0,0,149,1682
12/22/2021,3705,11,13,241,49,684,6,0,0,0,149,1688
12/23/2021,3708,12,13,242,49,679,2,0,0,0,149,1690
12/24/2021,3707,11,15,243,49,678,2,0,0,0,149,1692
12/25/2021,3704,12,15,246,49,677,4,0,0,0,149,1696
12/26/2021,3701,15,15,248,49,675,5,0,0,0,149,1701
12/27/2021,3698,14,18,249,49,675,3,0,0,0,149,1704
12/28/2021,3698,13,16,254,49,673,2,0,0,0,149,1706
12/29/2021,3697,12,20,255,49,670,4,0,0,0,149,1710
12/30/2021,3695,15,22,256,49,666,6,0,0,0,149,1716
12/31/2021,3690,19,19,260,49,666,6,0,0,0,149,1722
1/1/2022,3690,18,17,266,49,663,4,0,0,0,149,1726
1/2/2022,3691,12,22,268,49,661,1,0,0,0,149,1727
1/3/2022,3685,17,23,269,49,660,7,0,0,0,149,1734
1/4/2022,3684,17,21,273,49,659,2,0,0,0,149,1736
1/5/2022,3686,15,26,273,49,654,4,0,0,0,149,1740
1/6/2022,3683,17,22,280,49,652,5,0,0,0,149,1745
1/7/2022,3683,17,18,287,49,649,3,0,0,0,149,1748
1/8/2022,3676,23,14,292,49,649,7,0,0,0,149,1755
1/9/2022,3675,15,22,294,49,648,2,0,0,0,149,1757
1/10/2022,3674,16,24,296,49,644,5,0,0,0,149,1762
1/11/2022,3670,17,22,301,49,644,5,0,0,0,149,1767
1/12/2022,3666,19,20,305,49,644,5,0,0,0,149,1772
1/13/2022,3658,23,20,310,49,643,9,0,0,0,149,1781
1/14/2022,3654,22,23,313,49,642,5,0,0,0,149,1786
1/15/2022,3653,20,25,316,49,640,3,0,0,0,149,1789
1/16/2022,3654,18,25,321,49,636,3,0,0,0,149,1792
1/17/2022,3655,16,26,324,49,633,4,0,0,0,149,1796
1/18/2022,3654,16,22,330,49,632,3,0,0,0,149,1799
1/19/2022,3650,15,21,336,49,632,4,0,0,0,149,1803
1/20/2022,3646,14,22,341,49,631,5,0,0,0,149,1808
1/21/2022,3644,17,18,347,49,628,5,0,0,0,149,1813
1/22/2022,3648,14,19,350,49,623,1,0,0,0,149,1814
1/23/2022,3648,11,22,351,48,623,2,0,0,0,149,1816
1/24/2022,3648,12,22,354,48,619,5,0,0,0,149,1821
1/25/2022,3647,13,21,355,48,619,3,0,0,0,149,1824
1/26/2022,3647,9,24,357,48,618,1,0,0,0,149,1825
1/27/2022,3644,13,18,364,48,616,5,0,0,0,149,1830
1/28/2022,3641,14,15,369,48,616,3,0,0,0,149,1833
1/29/2022,3642,12,19,368,48,614,2,0,0,0,149,1835
1/30/2022,3640,16,19,371,48,609,7,0,0,0,149,1842
1/31/2022,3637,16,21,373,48,608,4,0,0,0,149,1846
2/1/2022,3633,19,18,377,48,608,4,1,1,0,150,1850
2/2/2022,3630,16,21,380,48,608,3,0,1,0,150,1853
2/3/2022,3628,16,23,382,48,606,4,0,1,0,150,1857
2/4/2022,3627,15,21,386,48,606,1,0,1,0,150,1858
2/5/2022,3627,10,26,389,48,603,3,0,1,0,150,1861
2/6/2022,3624,13,25,393,48,600,6,0,1,0,150,1867
2/7/2022,3623,9,19,404,48,600,1,0,1,0,150,1868
2/8/2022,3624,12,17,404,48,598,3,0,1,0,150,1871
2/9/2022,3623,11,17,407,48,597,2,0,1,0,150,1873
2/10/2022,3623,11,15,410,48,596,1,0,1,0,150,1874
2/11/2022,3623,8,17,412,48,595,1,0,1,0,150,1875
2/12/2022,3620,10,13,417,48,595,3,0,1,0,150,1878
2/13/2022,3617,11,11,421,48,595,3,0,0,0,150,1881
2/14/2022,3616,12,10,424,48,593,3,0,0,0,150,1884
2/15/2022,3614,12,11,425,48,593,2,0,0,0,150,1886
2/16/2022,3616,9,11,428,48,591,1,0,0,0,150,1887
2/17/2022,3616,10,10,431,48,588,3,0,0,0,150,1890
2/18/2022,3617,11,12,431,48,584,3,0,0,0,150,1893
2/19/2022,3616,10,11,434,48,584,1,0,0,0,150,1894
2/20/2022,3615,8,12,436,48,584,1,0,0,0,150,1895
2/21/2022,3617,4,13,439,48,582,0,0,0,0,150,1895
2/22/2022,3615,3,13,443,48,581,3,0,0,0,150,1898
2/23/2022,3617,6,12,444,48,576,4,0,0,0,150,1902
2/24/2022,3618,7,11,445,48,574,1,0,0,0,150,1903
2/25/2022,3621,5,11,446,48,572,0,0,0,0,150,1903
2/26/2022,3621,6,12,446,48,570,2,0,0,0,150,1905
2/27/2022,3620,7,9,451,48,568,3,0,0,0,150,1908
2/28/2022,3618,8,10,451,48,568,3,0,0,0,150,1911
3/1/2022,3618,7,9,454,48,567,1,0,0,0,150,1912
3/2/2022,3617,6,9,457,48,566,2,0,0,0,150,1914
3/3/2022,3619,7,8,459,48,562,2,0,0,0,150,1916
3/4/2022,3616,10,8,460,48,561,4,0,0,0,150,1920
3/5/2022,3613,9,11,461,48,561,3,0,0,0,150,1923
3/6/2022,3617,7,13,461,48,557,0,0,0,0,150,1923
3/7/2022,3616,9,14,462,48,554,4,0,0,0,150,1927
3/8/2022,3615,10,13,464,48,553,2,0,0,0,150,1929
3/9/2022,3613,8,15,468,48,551,4,0,0,0,150,1933
3/10/2022,3611,10,16,467,48,551,3,0,0,0,150,1936
3/11/2022,3607,15,15,468,48,550,6,0,0,0,150,1942
3/12/2022,3610,12,15,471,48,547,0,0,0,0,150,1942
3/13/2022,3610,10,13,475,48,547,2,0,0,0,150,1944
3/14/2022,3607,9,15,477,48,547,3,0,0,0,150,1947
3/15/2022,3606,11,13,480,48,545,3,0,0,0,150,1950
3/16/2022,3605,9,14,482,48,545,1,0,0,0,150,1951
3/17/2022,3599,15,13,484,48,544,7,0,0,0,150,1958
3/18/2022,3599,14,13,486,48,543,1,0,0,0,150,1959
3/19/2022,3598,13,13,488,48,543,2,0,0,0,150,1961
3/20/2022,3596,13,15,489,48,542,3,0,0,0,150,1964
3/21/2022,3599,12,12,492,48,540,0,0,0,0,150,1964
3/22/2022,3597,12,13,493,48,540,3,0,0,0,150,1967
3/23/2022,3598,7,17,494,48,539,0,0,0,0,150,1967
3/24/2022,3596,6,15,499,48,539,3,0,0,0,150,1970
3/25/2022,3597,6,13,503,48,536,2,0,0,0,150,1972
3/26/2022,3598,5,13,503,48,536,1,0,0,0,150,1973
3/27/2022,3600,4,13,504,48,534,0,0,0,0,150,1973
3/28/2022,3602,5,12,505,48,531,2,0,0,0,150,1975
3/29/2022,3602,4,11,507,48,531,0,0,0,0,150,1975
3/30/2022,3604,6,10,507,48,528,3,0,0,0,150,1978
3/31/2022,3602,8,8,509,48,528,2,0,0,0,150,1980
4/1/2022,3598,12,5,513,48,527,5,0,0,0,150,1985
4/2/2022,3602,8,8,514,48,523,0,0,0,0,150,1985
4/3/2022,3603,6,9,515,48,522,0,0,0,0,150,1985
4/4/2022,3605,6,8,516,48,520,1,0,0,0,150,1986
4/5/2022,3605,6,8,517,48,519,1,0,0,0,150,1987
4/6/2022,3605,4,8,518,48,520,0,0,0,0,150,1987
4/7/2022,3606,1,9,520,48,519,0,0,0,0,150,1987
4/8/2022,3604,4,6,523,48,518,3,0,0,0,150,1990
4/9/2022,3605,5,5,523,48,517,2,0,0,0,150,1992
4/10/2022,3605,4,4,525,48,517,0,0,0,0,150,1992
4/11/2022,3608,4,5,523,48,515,1,0,0,0,150,1993
4/12/2022,3608,5,3,524,48,515,1,0,0,0,150,1994
4/13/2022,3608,3,5,523,48,516,1,0,0,0,150,1995
4/14/2022,3608,4,6,523,48,514,2,0,0,0,150,1997
4/15/2022,3608,6,6,522,48,513,2,0,0,0,150,1999
4/16/2022,3609,3,8,523,48,512,0,0,0,0,150,1999
4/17/2022,3611,2,9,523,48,510,1,0,0,0,150,2000
4/18/2022,3611,2,10,523,48,509,1,0,0,0,150,2001
4/19/2022,3614,3,9,523,48,506,1,0,0,0,150,2002
4/20/2022,3613,3,9,524,48,506,1,0,0,0,150,2003
4/21/2022,3614,3,6,528,48,504,1,0,0,0,150,2004
4/22/2022,3615,3,4,528,48,505,0,0,0,0,150,2004
4/23/2022,3616,4,4,527,48,504,1,0,0,0,150,2005
4/24/2022,3617,3,5,525,48,505,0,0,0,0,150,2005
4/25/2022,3617,2,6,524,48,506,1,0,0,0,150,2006
4/26/2022,3617,2,5,525,48,506,0,0,0,0,150,2006
4/27/2022,3617,2,3,527,48,506,0,0,0,0,150,2006
4/28/2022,3619,1,2,528,48,505,0,0,0,0,150,2006
4/29/2022,3617,4,1,529,48,504,3,0,0,0,150,2009
4/30/2022,3621,4,1,527,48,502,0,0,0,0,150,2009
5/1/2022,3624,5,0,527,48,499,1,0,0,0,150,2010
5/2/2022,3623,4,2,526,48,500,1,0,0,0,150,2011
5/3/2022,3626,3,4,526,48,496,1,0,0,0,150,2012
5/4/2022,3626,4,4,526,48,495,1,0,0,0,150,2013
5/5/2022,3628,2,6,526,48,493,0,0,0,0,150,2013
5/6/2022,3630,2,5,525,48,493,0,0,0,0,150,2013
5/7/2022,3631,3,6,524,48,491,2,0,0,0,150,2015
5/8/2022,3635,3,5,524,48,488,0,0,0,0,150,2015
5/9/2022,3636,4,2,526,48,487,1,0,0,0,150,2016
5/10/2022,3635,4,4,525,48,487,2,0,0,0,150,2018
5/11/2022,3632,10,4,523,48,486,6,0,0,0,150,2024
5/12/2022,3633,10,4,521,48,487,1,0,0,0,150,2025
5/13/2022,3635,7,7,522,48,484,1,0,0,0,150,2026
5/14/2022,3634,8,6,524,48,483,2,0,0,0,150,2028
5/15/2022,3634,6,7,525,48,483,0,0,0,0,150,2028
5/16/2022,3637,5,9,525,48,479,1,0,0,0,150,2029
5/17/2022,3634,7,9,524,48,481,4,0,0,0,150,2033
5/18/2022,3636,7,11,522,48,479,2,0,0,0,150,2035
5/19/2022,3635,9,10,523,48,478,3,0,0,0,150,2038
5/20/2022,3637,8,10,525,48,475,1,0,0,0,150,2039
5/21/2022,3636,9,10,525,48,475,2,0,0,0,150,2041
5/22/2022,3638,9,9,525,48,474,2,0,0,0,150,2043
5/23/2022,3638,6,11,527,48,473,1,0,0,0,150,2044
5/24/2022,3637,6,13,526,48,473,2,0,0,0,150,2046
5/25/2022,3641,6,14,525,48,469,1,0,0,0,150,2047
5/26/2022,3644,4,14,524,48,469,0,0,0,0,150,2047
5/27/2022,3645,5,15,524,48,466,3,0,0,0,150,2050
5/28/2022,3644,5,16,524,48,466,2,0,0,0,150,2052
5/29/2022,3647,6,11,526,48,465,1,0,0,0,150,2053
5/30/2022,3648,4,13,525,48,465,0,0,0,0,150,2053
5/31/2022,3650,4,10,527,48,464,1,0,0,0,150,2054
6/1/2022,3651,4,10,528,48,462,1,0,0,0,150,2055
6/2/2022,3652,6,9,527,48,461,2,0,0,0,150,2057
6/3/2022,3652,5,8,529,48,461,1,0,0,0,150,2058
6/4/2022,3651,6,8,528,48,462,1,0,0,0,150,2059
6/5/2022,3650,6,10,527,48,462,3,0,0,0,150,2062
6/6/2022,3648,9,7,527,48,464,3,0,0,0,150,2065
6/7/2022,3649,9,6,527,48,464,1,0,0,0,150,2066
6/8/2022,3650,10,8,523,48,464,3,0,0,0,150,2069
6/9/2022,3651,9,7,525,48,463,1,0,0,0,150,2070
6/10/2022,3652,10,7,525,48,461,2,0,0,0,150,2072
6/11/2022,3655,9,8,525,48,458,1,0,0,0,150,2073
6/12/2022,3656,8,10,524,48,457,1,0,0,0,150,2074
6/13/2022,3657,6,13,524,48,455,2,0,0,0,150,2076
6/14/2022,3657,7,11,525,48,455,2,0,0,0,150,2078
6/15/2022,3658,6,13,524,48,454,1,0,0,0,150,2079
6/16/2022,3662,3,13,524,48,453,0,0,0,0,150,2079
6/17/2022,3663,4,12,523,48,453,2,0,0,0,150,2081
6/18/2022,3662,3,13,524,48,453,1,0,0,0,150,2082
6/19/2022,3665,3,10,527,48,450,0,0,0,0,150,2082
6/20/2022,3669,3,10,527,48,446,0,0,0,0,150,2082
6/21/2022,3671,3,7,530,48,444,1,0,0,0,150,2083
6/22/2022,3673,2,4,532,48,444,0,0,0,0,150,2083
6/23/2022,3674,2,3,532,48,444,0,0,0,0,150,2083
6/24/2022,3675,1,3,532,48,444,0,0,0,0,150,2083
6/25/2022,3678,1,1,531,48,444,0,0,0,0,150,2083
6/26/2022,3683,0,1,530,48,441,0,0,0,0,150,2083
6/27/2022,3685,1,0,529,48,440,1,0,0,0,150,2084
6/28/2022,3688,1,0,527,48,439,0,0,0,0,150,2084
6/29/2022,3690,1,0,527,48,437,0,0,0,0,150,2084
6/30/2022,3691,1,0,525,48,438,0,0,0,0,150,2084
7/1/2022,3693,1,0,523,48,438,0,0,0,0,150,2084
7/2/2022,3698,1,0,522,48,434,0,0,0,0,150,2084
7/3/2022,3698,1,0,522,48,434,0,0,0,0,150,2084
7/4/2022,3697,2,0,522,48,434,1,0,0,0,150,2085
7/5/2022,3703,2,0,518,48,432,0,0,0,0,150,2085
7/6/2022,3703,1,1,518,48,432,0,0,0,0,150,2085
7/7/2022,3705,1,0,517,48,432,0,0,0,0,150,2085
7/8/2022,3705,2,1,516,48,431,2,0,0,0,150,2087
7/9/2022,3707,2,1,516,48,429,0,0,0,0,150,2087
7/10/2022,3708,2,1,514,48,430,0,0,0,0,150,2087
7/11/2022,3709,2,1,514,48,429,0,0,0,0,150,2087
7/12/2022,3711,1,1,515,48,427,0,0,0,0,150,2087
7/13/2022,3715,1,1,513,48,425,0,0,0,0,150,2087
7/14/2022,3716,1,1,512,48,425,0,0,0,0,150,2087
7/15/2022,3719,1,2,508,48,425,1,0,0,0,150,2088
7/16/2022,3721,1,1,509,48,423,1,0,0,0,150,2089
7/17/2022,3723,1,2,508,48,421,1,0,0,0,150,2090
7/18/2022,3727,1,2,506,48,419,0,0,0,0,150,2090
7/19/2022,3729,1,2,504,48,419,0,0,0,0,150,2090
7/20/2022,3731,1,2,503,48,418,0,0,0,0,150,2090
7/21/2022,3731,1,3,501,48,419,1,0,0,0,150,2091
7/22/2022,3732,2,3,500,48,418,1,0,0,0,150,2092
7/23/2022,3733,2,3,497,48,420,1,0,0,0,150,2093
7/24/2022,3736,2,3,495,48,419,0,0,0,0,150,2093
7/25/2022,3737,2,4,493,48,419,1,0,0,0,150,2094
7/26/2022,3737,3,4,492,48,419,1,0,0,0,150,2095
7/27/2022,3737,3,3,493,48,419,1,0,0,0,150,2096
7/28/2022,3740,2,4,491,48,418,0,0,0,0,150,2096
7/29/2022,3740,3,4,490,48,418,1,0,0,0,150,2097
7/30/2022,3742,2,4,488,48,419,0,0,0,0,150,2097
7/31/2022,3743,3,4,487,48,418,1,0,0,0,150,2098
8/1/2022,3743,3,4,487,48,418,0,0,0,0,150,2098
8/2/2022,3742,3,5,487,48,418,1,0,0,0,150,2099
8/3/2022,3742,5,3,485,48,420,2,0,0,0,150,2101
8/4/2022,3742,6,2,485,48,420,1,0,0,0,150,2102
8/5/2022,3746,5,2,484,48,418,0,0,0,0,150,2102
8/6/2022,3748,2,6,483,48,416,1,0,0,0,150,2103
8/7/2022,3749,4,5,481,48,416,2,0,0,0,150,2105
8/8/2022,3753,4,6,479,48,413,1,0,0,0,150,2106
8/9/2022,3754,5,6,477,48,413,1,0,0,0,150,2107
8/10/2022,3755,4,7,476,48,413,1,0,0,0,150,2108
8/11/2022,3755,5,4,478,48,413,1,0,0,0,150,2109
8/12/2022,3758,2,6,478,48,411,0,0,0,0,150,2109
8/13/2022,3763,1,7,473,48,411,0,0,0,0,150,2109
8/14/2022,3765,2,5,473,48,410,1,0,0,0,150,2110
8/15/2022,3768,2,3,473,48,409,0,0,0,0,150,2110
8/16/2022,3772,1,4,470,48,408,0,0,0,0,150,2110
8/17/2022,3773,1,4,468,48,409,1,0,0,0,150,2111
8/18/2022,3774,2,3,466,48,410,1,0,0,0,150,2112
8/19/2022,3776,2,4,461,48,412,1,0,0,0,150,2113
8/20/2022,3778,2,4,458,48,413,1,0,0,0,150,2114
8/21/2022,3780,2,3,456,48,414,0,0,0,0,150,2114
8/22/2022,3781,2,3,456,48,413,1,0,0,0,150,2115
8/23/2022,3785,2,4,452,48,412,1,0,0,0,150,2116
8/24/2022,3786,2,3,452,48,412,1,0,0,0,150,2117
8/25/2022,3786,3,3,449,48,414,1,0,0,0,150,2118
8/26/2022,3791,3,3,447,48,411,0,0,0,0,150,2118
8/27/2022,3791,2,4,446,48,412,0,0,0,0,150,2118
8/28/2022,3790,2,5,444,48,414,1,0,0,0,150,2119
8/29/2022,3789,3,4,443,48,416,1,0,0,0,150,2120
8/30/2022,3791,2,5,438,48,419,0,0,0,0,150,2120
8/31/2022,3793,1,5,437,48,419,0,0,0,0,150,2120
9/1/2022,3794,3,2,440,48,416,2,0,0,0,150,2122
9/2/2022,3794,2,3,440,48,416,0,0,0,0,150,2122
9/3/2022,3795,2,3,438,48,417,0,0,0,0,150,2122
9/4/2022,3798,2,2,437,48,416,0,0,0,0,150,2122
9/5/2022,3801,3,2,433,48,416,1,0,0,0,150,2123
9/6/2022,3802,2,3,429,48,419,0,0,0,0,150,2123
9/7/2022,3805,3,2,427,48,418,1,0,0,0,150,2124
9/8/2022,3804,4,3,424,48,420,2,0,0,0,150,2126
9/9/2022,3806,5,2,422,48,420,1,0,0,0,150,2127
9/10/2022,3809,4,4,419,48,419,1,0,0,0,150,2128
9/11/2022,3807,7,1,419,48,421,3,0,0,0,150,2131
9/12/2022,3806,5,4,418,48,422,1,0,0,0,150,2132
9/13/2022,3806,5,4,416,48,424,0,0,0,0,150,2132
9/14/2022,3805,4,7,414,48,425,2,0,0,0,150,2134
9/15/2022,3805,4,7,410,48,429,1,0,0,0,150,2135
9/16/2022,3807,2,8,409,48,429,0,0,0,0,150,2135
9/17/2022,3809,2,5,411,48,428,0,0,0,0,150,2135
9/18/2022,3810,4,6,408,48,427,3,0,0,0,150,2138
9/19/2022,3812,5,6,406,48,426,1,0,0,0,150,2139
9/20/2022,3813,6,7,401,48,428,2,0,0,0,150,2141
9/21/2022,3812,6,9,399,48,429,3,0,0,0,150,2144
9/22/2022,3812,5,11,396,48,431,1,0,0,0,150,2145
9/23/2022,3813,5,7,398,48,432,0,0,0,0,150,2145
9/24/2022,3815,4,6,398,48,432,0,0,0,0,150,2145
9/25/2022,3815,3,7,398,48,432,1,0,0,0,150,2146
9/26/2022,3814,5,8,395,48,433,4,0,0,0,150,2150
9/27/2022,3813,9,7,394,48,432,4,0,0,0,150,2154
9/28/2022,3816,9,8,388,48,434,1,0,0,0,150,2155
9/29/2022,3816,6,12,385,48,436,1,0,0,0,150,2156
9/30/2022,3818,4,14,385,48,434,0,0,0,0,150,2156
10/1/2022,3823,2,15,381,48,434,0,0,0,0,150,2156
10/2/2022,3822,3,15,379,48,436,2,0,0,0,150,2158
10/3/2022,3823,2,11,384,48,435,0,0,0,0,150,2158
10/4/2022,3821,4,11,382,48,437,3,0,0,0,150,2161
10/5/2022,3823,6,10,380,48,436,2,0,0,0,150,2163
10/6/2022,3825,7,7,377,48,439,1,0,0,0,150,2164
10/7/2022,3827,6,6,378,48,438,0,0,0,0,150,2164
10/8/2022,3828,3,8,376,48,440,1,0,0,0,150,2165
10/9/2022,3831,4,7,373,48,440,2,0,0,0,150,2167
10/10/2022,3830,7,7,370,48,441,3,0,0,0,150,2170
10/11/2022,3830,7,8,370,48,440,2,0,0,0,150,2172
10/12/2022,3830,7,9,370,48,439,2,1,1,0,151,2174
10/13/2022,3830,5,11,369,48,440,0,0,1,0,151,2174
10/14/2022,3827,9,10,369,48,440,5,0,1,0,151,2179
10/15/2022,3830,9,12,367,48,437,2,0,1,0,151,2181
10/16/2022,3832,9,12,366,48,436,2,0,1,0,151,2183
10/17/2022,3831,10,12,365,48,437,4,0,1,0,151,2187
10/18/2022,3831,11,8,368,48,437,1,0,1,0,151,2188
10/19/2022,3832,9,11,365,48,438,1,0,1,0,151,2189
10/20/2022,3835,7,14,361,48,438,1,0,1,0,151,2190
10/21/2022,3835,10,11,357,48,442,3,0,1,0,151,2193
10/22/2022,3836,7,11,359,48,442,0,0,1,0,151,2193
10/23/2022,3836,6,12,360,48,441,1,0,1,0,151,2194
10/24/2022,3841,5,10,358,48,441,0,0,1,0,151,2194
10/25/2022,3840,7,9,359,48,440,3,0,1,0,151,2197
10/26/2022,3839,8,8,358,48,442,1,0,1,0,151,2198
10/27/2022,3837,7,11,357,48,443,2,0,1,0,151,2200
10/28/2022,3840,6,7,361,48,441,0,0,1,0,151,2200
10/29/2022,3841,4,5,365,48,440,1,0,0,0,151,2201
10/30/2022,3843,2,7,363,48,440,0,0,0,0,151,2201
10/31/2022,3844,2,7,361,48,441,0,0,0,0,151,2201
11/1/2022,3844,4,6,362,48,439,3,0,0,0,151,2204
11/2/2022,3841,7,6,360,48,441,4,0,0,0,151,2208
11/3/2022,3843,7,5,361,48,439,1,0,0,0,151,2209
11/4/2022,3843,8,5,359,48,440,1,0,0,0,151,2210
11/5/2022,3845,8,7,355,48,440,2,0,0,0,151,2212
11/6/2022,3846,8,7,356,48,438,1,0,0,0,151,2213
11/7/2022,3851,5,11,353,48,435,1,0,0,0,151,2214
11/8/2022,3849,7,10,354,48,435,4,0,0,0,151,2218
11/9/2022,3847,8,7,357,48,436,3,0,0,0,151,2221
11/10/2022,3848,6,9,356,48,436,1,0,0,0,151,2222
11/11/2022,3850,5,9,356,48,435,0,0,0,0,151,2222
11/12/2022,3851,4,10,355,48,435,0,0,0,0,151,2222
11/13/2022,3853,3,9,357,48,433,1,0,0,0,151,2223
11/14/2022,3850,6,9,357,48,433,4,0,0,0,151,2227
11/15/2022,3845,11,8,357,48,434,6,0,0,0,151,2233
11/16/2022,3844,14,6,358,48,433,3,0,0,0,151,2236
11/17/2022,3845,15,5,358,48,432,2,0,0,0,151,2238
11/18/2022,3849,14,6,356,48,430,1,0,0,0,151,2239
11/19/2022,3848,13,8,355,48,431,2,0,0,0,151,2241
11/20/2022,3849,8,12,355,48,431,0,0,0,0,151,2241
11/21/2022,3846,11,11,356,48,431,4,0,0,0,151,2245
11/22/2022,3845,13,11,357,48,429,5,0,0,0,151,2250
11/23/2022,3844,10,14,358,48,429,2,0,0,0,151,2252
11/24/2022,3840,13,13,360,48,429,5,0,0,0,151,2257
11/25/2022,3836,16,13,360,48,430,5,0,0,0,151,2262
11/26/2022,3834,15,16,359,48,431,3,0,0,0,151,2265
11/27/2022,3832,17,14,362,48,430,5,0,0,0,151,2270
11/28/2022,3833,17,16,358,48,431,3,0,0,0,151,2273
11/29/2022,3834,13,17,360,48,431,1,0,0,0,151,2274
11/30/2022,3829,16,16,363,48,431,5,0,0,0,151,2279
12/1/2022,3830,15,20,362,48,428,6,0,0,0,151,2285
12/2/2022,3826,17,19,366,48,427,6,0,0,0,151,2291
12/3/2022,3825,19,21,364,48,426,5,0,0,0,151,2296
12/4/2022,3823,21,20,367,48,424,4,0,0,0,151,2300
12/5/2022,3822,20,22,368,48,423,3,0,0,0,151,2303
12/6/2022,3823,10,29,367,48,426,1,0,0,0,151,2304
12/7/2022,3821,11,28,369,48,426,6,0,0,0,151,2310
12/8/2022,3821,12,24,373,48,425,3,0,0,0,151,2313
12/9/2022,3815,13,25,377,48,425,6,0,0,0,151,2319
12/10/2022,3808,21,21,379,48,426,11,0,0,0,151,2330
12/11/2022,3806,21,21,380,48,427,3,0,0,0,151,2333
12/12/2022,3804,23,20,382,48,426,6,0,0,0,151,2339
12/13/2022,3803,18,25,384,48,425,3,0,0,0,151,2342
12/14/2022,3799,16,29,384,48,427,4,0,0,0,151,2346
12/15/2022,3795,19,26,389,48,426,6,0,0,0,151,2352
12/16/2022,3790,20,28,391,48,426,7,0,0,0,151,2359
12/17/2022,3790,17,30,392,48,426,2,0,0,0,151,2361
12/18/2022,3785,19,28,398,48,425,7,0,0,0,151,2368
12/19/2022,3787,14,32,401,48,421,3,0,0,0,151,2371
12/20/2022,3783,16,31,403,48,422,6,0,0,0,151,2377
12/21/2022,3778,17,31,407,48,422,6,0,0,0,151,2383
12/22/2022,3771,22,27,413,48,422,9,0,0,0,151,2392
12/23/2022,3770,18,28,418,48,421,3,0,0,0,151,2395
12/24/2022,3766,18,24,426,48,421,4,0,0,0,151,2399
12/25/2022,3765,17,26,429,48,418,5,0,0,0,151,2404
12/26/2022,3764,17,26,429,48,419,3,0,0,0,151,2407
12/27/2022,3760,21,26,431,48,417,8,0,0,0,151,2415
12/28/2022,3756,19,26,437,48,417,4,0,0,0,151,2419
12/29/2022,3752,19,26,441,48,417,5,0,0,0,151,2424
12/30/2022,3748,17,29,444,48,417,5,0,0,0,151,2429
12/31/2022,3742,23,29,445,48,416,9,0,0,0,151,2438
1/1/2023,3739,24,32,445,48,415,6,0,0,0,151,2444
1/2/2023,3740,23,29,449,48,414,4,0,0,0,151,2448
1/3/2023,3734,26,30,451,48,414,9,0,0,0,151,2457
1/4/2023,3727,24,36,454,48,414,7,0,0,0,151,2464
1/5/2023,3721,25,35,460,48,414,6,0,0,0,151,2470
1/6/2023,3721,22,34,464,48,414,1,0,0,0,151,2471
1/7/2023,3716,22,34,467,48,416,5,0,0,0,151,2476
1/8/2023,3710,22,36,473,48,414,8,0,0,0,151,2484
1/9/2023,3702,26,29,483,48,415,8,0,0,0,151,2492
1/10/2023,3698,25,29,489,48,414,5,0,0,0,151,2497
1/11/2023,3687,32,28,494,48,414,12,0,0,0,151,2509
1/12/2023,3681,34,28,498,48,414,8,0,0,0,151,2517
1/13/2023,3680,29,31,501,48,414,2,0,0,0,151,2519
1/14/2023,3675,28,33,506,48,413,7,0,0,0,151,2526
1/15/2023,3672,26,36,509,48,412,5,0,0,0,151,2531
1/16/2023,3664,28,37,514,48,412,9,0,0,0,151,2540
1/17/2023,3657,27,40,518,48,413,9,0,0,0,151,2549
1/18/2023,3653,24,42,522,48,414,5,0,0,0,151,2554
1/19/2023,3647,24,42,529,48,413,7,0,0,0,151,2561
1/20/2023,3644,19,43,537,48,412,5,0,0,0,151,2566
1/21/2023,3638,27,37,543,47,411,9,1,1,0,152,2575
1/22/2023,3629,27,41,547,47,412,9,0,1,0,152,2584
1/23/2023,3623,26,40,554,47,413,6,0,1,0,152,2590
1/24/2023,3621,26,37,559,47,413,6,0,1,0,152,2596
1/25/2023,3615,28,38,561,47,414,8,0,1,0,152,2604
1/26/2023,3605,35,40,562,47,414,12,0,1,0,152,2616
1/27/2023,3604,31,39,570,47,412,5,0,1,0,152,2621
1/28/2023,3599,27,48,570,47,412,7,0,1,0,152,2628
1/29/2023,3590,29,47,578,47,412,9,0,1,0,152,2637
1/30/2023,3583,31,47,582,47,413,9,0,1,0,152,2646
1/31/2023,3582,24,49,588,47,413,4,0,1,0,152,2650
2/1/2023,3574,30,43,598,47,411,11,0,1,0,152,2661
2/2/2023,3563,33,44,605,47,411,11,0,1,0,152,2672
2/3/2023,3551,39,46,609,47,411,12,0,1,0,152,2684
2/4/2023,3542,38,50,615,47,411,9,0,1,0,152,2693
2/5/2023,3535,40,45,626,47,410,9,1,2,0,153,2702
2/6/2023,3531,33,50,632,47,410,5,0,2,0,153,2707
2/7/2023,3525,33,52,638,47,408,8,0,2,0,153,2715
2/8/2023,3518,36,50,644,47,408,8,0,2,0,153,2723
2/9/2023,3515,37,48,648,47,408,8,0,2,0,153,2731
2/10/2023,3505,40,44,661,47,406,12,0,2,0,153,2743
2/11/2023,3498,37,48,668,47,405,8,0,2,0,153,2751
2/12/2023,3492,32,51,677,47,404,7,1,3,0,154,2758
2/13/2023,3484,38,47,684,48,402,11,0,2,0,154,2769
2/14/2023,3476,37,46,693,48,403,9,0,2,0,154,2778
2/15/2023,3475,30,46,700,48,404,1,0,2,0,154,2779
2/16/2023,3468,26,45,712,48,404,7,0,2,0,154,2786
2/17/2023,3462,32,39,720,48,402,9,0,2,0,154,2795
2/18/2023,3455,35,33,730,48,402,9,0,2,0,154,2804
2/19/2023,3454,28,38,734,48,401,3,0,1,0,154,2807
2/20/2023,3446,30,40,740,48,399,10,0,1,0,154,2817
2/21/2023,3443,30,39,744,48,399,5,0,1,0,154,2822
2/22/2023,3442,20,41,753,48,399,3,0,1,0,154,2825
2/23/2023,3438,19,37,763,48,398,7,0,1,0,154,2832
2/24/2023,3429,25,32,771,48,398,9,0,1,0,154,2841
2/25/2023,3427,24,25,783,48,396,4,0,1,0,154,2845
2/26/2023,3424,21,27,787,48,396,4,0,1,0,154,2849
2/27/2023,3426,18,30,786,48,395,3,0,1,0,154,2852
2/28/2023,3424,16,29,793,48,393,5,0,0,0,154,2857
3/1/2023,3421,16,28,796,48,394,5,0,0,0,154,2862
3/2/2023,3418,14,31,797,48,395,4,0,0,0,154,2866
3/3/2023,3416,15,26,802,48,396,3,0,0,0,154,2869
3/4/2023,3415,13,28,803,48,396,3,0,0,0,154,2872
3/5/2023,3411,16,25,806,48,397,5,0,0,0,154,2877
3/6/2023,3409,16,24,810,48,396,3,0,0,0,154,2880
